InteractiveWall	KEYWORD1

setColor		KEYWORD2
showColor	KEYWORD2
showAll		KEYWORD2
blank		KEYWORD2
getColor		KEYWORD2
mapColor	KEYWORD2

NUMSTRIPS	LITERAL1
NUMROW	LITERAL1
NUMCOL	LITERAL1
NUMCOLOR	LITERAL1
DELAYVAL	LITERAL1
COLOR_RED	LITERAL1
COLOR_ORANGE	LITERAL1
COLOR_YELLOW	LITERAL1
COLOR_GREEN	LITERAL1
COLOR_TEAL	LITERAL1
COLOR_BLUE	LITERAL1
COLOR_MAGENTA	LITERAL1
COLOR_BLANK	LITERAL1
